 SO      ./textures/xpm/bark.xpm
EA         ./textures/xpm/bookshelf.xpm
NO  ./textures/xpm/bricks.xpm
C             80,170,230

   WE   ./textures/xpm/door.xpm


         F 170,100,30

1111
1001111111111
110000000001
1100000010001
1100000010001
1100000010001
1100000010001
100N000100001
1111111111111
