 SO      ./textures/xpm/bark.xpm
EA         ./textures/xpm/bookshelf.xpm
NO  ./textures/xpm/bricks.xpm
C             80,170,230

   WE   ./textures/xpm/door.xpm


         F 170,100,30

1111
1001111111111
1100100000001
1000010100001
10001000000011
110000010001
100W00100001
10000101010011
1001000000001
10000001000011
1100100000001
1000010100001
10001010000011
110000010001
100000100001
10000101010011
1000000000001
10000001000011
1111111111111
