SO      ./textures/xpm/south_rock.xpm
EA ./textures/xpm/east_rock.xpm

F             -21,32,11

NO  ./textures/xpm/north_rock.xpm


C             25,255,1

   WE   ./textures/xpm/west_rock.xpm


1111111
1000001
1000001
100N001
1000001
1000001
1111111
