SO      ./textures/xpm/south_rock.xpm
EA ./textures/xpm/east_rock.xpm

NO  ./textures/xpm/north_rock.xpm

   WE   ./textures/xpm/west_rock.xpm



C             255,255,250
F             21,32,11

1111111
1000001
1000001
1000001
1000001
1000001
1111111
